111111111111111
100010000000001
100000100000101
100000000010001
100000000000001
111111111111111
